1111111111111111
1E000000!000C001
1010010100100101
1010011010010001
1P00000C00C0o001
1111111111111111