111111111111
1E01000!0001
1!0C01111!01
1P0C11E000E1
111111111111